                                                    
                                                    
                                                    
                                                    
    BBBB    BBBB    BBBB    BBBB    BBBB    BBBB    
    BBBB    BBBB    BBBB    BBBB    BBBB    BBBB    
    BBBB    BBBB    BBBB    BBBB    BBBB    BBBB    
    BBBB    BBBB    BBBB    BBBB    BBBB    BBBB    
    BBBB    BBBB    BBBB    BBBB    BBBB    BBBB    
    BBBB    BBBB    BBBB    BBBB    BBBB    BBBB    
    BBBB    BBBB    BBBB    BBBB    BBBB    BBBB    
    BBBB    BBBB    BBBB    BBBB    BBBB    BBBB    
    BBBB    BBBB    BBBB    BBBB    BBBB    BBBB    
    BBBB    BBBB    BBBB    BBBB    BBBB    BBBB    
    BBBB    BBBB    BBBBMMMMBBBB    BBBB    BBBB    
    BBBB    BBBB    BBBBMMMMBBBB    BBBB    BBBB    
    BBBB    BBBB    BBBBMMMMBBBB    BBBB    BBBB    
    BBBB    BBBB    BBBBMMMMBBBB    BBBB    BBBB    
    BBBB    BBBB    BBBB    BBBB    BBBB    BBBB    
    BBBB    BBBB    BBBB    BBBB    BBBB    BBBB    
    BBBB    BBBB                    BBBB    BBBB    
    BBBB    BBBB                    BBBB    BBBB    
    BBBB    BBBB                    BBBB    BBBB    
    BBBB    BBBB                    BBBB    BBBB    
                    BBBB    BBBB                    
                    BBBB    BBBB                    
                    BBBB    BBBB                    
                    BBBB    BBBB                    
BBBB    BBBBBBBB                    BBBBBBBB    BBBB
BBBB    BBBBBBBB                    BBBBBBBB    BBBB
MMMM    BBBBBBBB                    BBBBBBBB    MMMM
MMMM    BBBBBBBB                    BBBBBBBB    MMMM
                    BBBB    BBBB                    
                    BBBB    BBBB                    
                    BBBBBBBBBBBB                    
                    BBBBBBBBBBBB                    
    BBBB    BBBB    BBBBBBBBBBBB    BBBB    BBBB    
    BBBB    BBBB    BBBBBBBBBBBB    BBBB    BBBB    
    BBBB    BBBB    BBBB    BBBB    BBBB    BBBB    
    BBBB    BBBB    BBBB    BBBB    BBBB    BBBB    
    BBBB    BBBB    BBBB    BBBB    BBBB    BBBB    
    BBBB    BBBB    BBBB    BBBB    BBBB    BBBB    
    BBBB    BBBB                    BBBB    BBBB    
    BBBB    BBBB                    BBBB    BBBB    
    BBBB    BBBB                    BBBB    BBBB    
    BBBB    BBBB                    BBBB    BBBB    
    BBBB    BBBB      BBBBBBBB      BBBB    BBBB    
    BBBB    BBBB      BBBBBBBB      BBBB    BBBB    
                      BB    BB                      
                      BB    BB                      
                      BB    BB                      
                      BB    BB                      